24
24
XXXXXXXXXXXXXXXXXXXXXXXX
X          XX          X
X XXXXXX X XX X XXXXXX X
X X      X XX X      X X
X X XX X X XX X X XX X X
X X XX X        X XX X X
X X    XXXXXXXXXX    X X
X   X XX   XX   XX X   X
XXXXX    X    X    XXXXX
X     XX XXXXXX XX     X
X XXXXXX        XXXXXX X
X    X   XX  XX   X    X
X XX X X X    X X X XX X
X X    X XXXXXX X    X X
X X XX X X    X X XX X X
X X    X   XX   X    X X
X XXXX X X XX X X XXXX X
X X    X   XX   X    X X
X   XXXX XXXXXX XXXX   X
XXX    X   XX   X    XXX
X   XX XXX XX XXX XX   X
X XXXX X   XX   X XXXX X
X        X    X        X
XXXXXXXXXXXXXXXXXXXXXXXX
